{
  "name": "Winry315",
  "vendorProductId": 4059104021,
  "macros": [
    "{KC_LGUI,KC_LCTL,KC_LEFT}",
    "{KC_LGUI,KC_LCTL,KC_RGHT}",
    "{KC_LGUI,KC_LALT,KC_RGHT,KC_LCTL,KC_LALT,KC_SPC}",
    "{KC_LGUI,KC_LALT,KC_LEFT,KC_LCTL,KC_LALT,KC_SPC}",
    "{KC_LCTL,KC_LALT,KC_LEFT}",
    "{KC_LCTL,KC_LALT,KC_RGHT}",
    "",
    "{KC_LCTL,KC_LALT,KC_SPC}",
    "",
    "",
    "git cola &\n",
    "",
    "",
    "",
    "",
    ""
  ],
  "layers": [
    [
      "MACRO(10)",
      "MACRO(1)",
      "MACRO(2)",
      "MACRO(3)",
      "MACRO(4)",
      "MACRO(5)",
      "MACRO(6)",
      "MACRO(7)",
      "MACRO(8)",
      "MACRO(9)",
      "MACRO(10)",
      "MACRO(11)",
      "MACRO(12)",
      "MACRO(13)",
      "MACRO(14)",
      "MACRO(7)",
      "KC_G",
      "KC_D",
      "MACRO(3)",
      "MACRO(2)",
      "MACRO(4)",
      "MACRO(5)",
      "MACRO(0)",
      "MACRO(1)"
    ],
    [
      "RGB_MOD",
      "RGB_HUI",
      "RGB_SAI",
      "RGB_VAI",
      "RGB_SPI",
      "RGB_RMOD",
      "RGB_HUD",
      "RGB_SAD",
      "RGB_VAD",
      "RGB_SPD",
      "KC_TRNS",
      "RGB_TOG",
      "RGB_M_P",
      "RGB_M_B",
      "RGB_M_R",
      "RGB_M_SW",
      "RGB_M_R",
      "RGB_M_P",
      "RGB_SAI",
      "RGB_SAD",
      "RGB_VAI",
      "RGB_VAD",
      "RGB_HUI",
      "RGB_HUD"
    ],
    [
      "KC_TRNS",
      "KC_TRNS",
      "KC_TRNS",
      "KC_TRNS",
      "KC_TRNS",
      "KC_TRNS",
      "KC_TRNS",
      "KC_TRNS",
      "KC_TRNS",
      "KC_TRNS",
      "KC_TRNS",
      "KC_TRNS",
      "KC_TRNS",
      "KC_TRNS",
      "KC_TRNS",
      "KC_TRNS",
      "KC_TRNS",
      "KC_TRNS",
      "KC_TRNS",
      "KC_TRNS",
      "KC_TRNS",
      "KC_TRNS",
      "KC_TRNS",
      "KC_TRNS"
    ],
    [
      "KC_TRNS",
      "KC_TRNS",
      "KC_TRNS",
      "KC_TRNS",
      "KC_TRNS",
      "KC_TRNS",
      "KC_TRNS",
      "KC_TRNS",
      "KC_TRNS",
      "KC_TRNS",
      "KC_TRNS",
      "KC_TRNS",
      "KC_TRNS",
      "KC_TRNS",
      "KC_TRNS",
      "KC_TRNS",
      "KC_TRNS",
      "KC_TRNS",
      "KC_TRNS",
      "KC_TRNS",
      "KC_TRNS",
      "KC_TRNS",
      "KC_TRNS",
      "KC_TRNS"
    ],
    [
      "KC_TRNS",
      "KC_TRNS",
      "KC_TRNS",
      "KC_TRNS",
      "KC_TRNS",
      "KC_TRNS",
      "KC_TRNS",
      "KC_TRNS",
      "KC_TRNS",
      "KC_TRNS",
      "KC_TRNS",
      "KC_TRNS",
      "KC_TRNS",
      "KC_TRNS",
      "KC_TRNS",
      "KC_TRNS",
      "KC_TRNS",
      "KC_TRNS",
      "KC_TRNS",
      "KC_TRNS",
      "KC_TRNS",
      "KC_TRNS",
      "KC_TRNS",
      "KC_TRNS"
    ],
    [
      "KC_TRNS",
      "KC_TRNS",
      "KC_TRNS",
      "KC_TRNS",
      "KC_TRNS",
      "KC_TRNS",
      "KC_TRNS",
      "KC_TRNS",
      "KC_TRNS",
      "KC_TRNS",
      "KC_TRNS",
      "KC_TRNS",
      "KC_TRNS",
      "KC_TRNS",
      "KC_TRNS",
      "KC_TRNS",
      "KC_TRNS",
      "KC_TRNS",
      "KC_TRNS",
      "KC_TRNS",
      "KC_TRNS",
      "KC_TRNS",
      "KC_TRNS",
      "KC_TRNS"
    ],
    [
      "KC_TRNS",
      "KC_TRNS",
      "KC_TRNS",
      "KC_TRNS",
      "KC_TRNS",
      "KC_TRNS",
      "KC_TRNS",
      "KC_TRNS",
      "KC_TRNS",
      "KC_TRNS",
      "KC_TRNS",
      "KC_TRNS",
      "KC_TRNS",
      "KC_TRNS",
      "KC_TRNS",
      "KC_TRNS",
      "KC_TRNS",
      "KC_TRNS",
      "KC_TRNS",
      "KC_TRNS",
      "KC_TRNS",
      "KC_TRNS",
      "KC_TRNS",
      "KC_TRNS"
    ],
    [
      "KC_TRNS",
      "KC_TRNS",
      "KC_TRNS",
      "KC_TRNS",
      "KC_TRNS",
      "KC_TRNS",
      "KC_TRNS",
      "KC_TRNS",
      "KC_TRNS",
      "KC_TRNS",
      "KC_TRNS",
      "KC_TRNS",
      "KC_TRNS",
      "KC_TRNS",
      "KC_TRNS",
      "KC_TRNS",
      "KC_TRNS",
      "KC_TRNS",
      "KC_TRNS",
      "KC_TRNS",
      "KC_TRNS",
      "KC_TRNS",
      "KC_TRNS",
      "KC_TRNS"
    ]
  ],
  "encoders": []
}
