{
  "name": "Winry315",
  "vendorProductId": 4059104021,
  "macros": [
    "{KC_LGUI,KC_C}",
    "{KC_LGUI,KC_V}",
    "{KC_LSFT,KC_LCTL,KC_TAB}",
    "{+KC_LGUI}w{-KC_LGUI}",
    "{KC_LCTL,KC_TAB}",
    "",
    "",
    "",
    "",
    "",
    "",
    "",
    "",
    "",
    "Hey, hope you like the macro keypad! I hope it brings some joy to your developer workflow. Will",
    ""
  ],
  "layers": [
    [
      "MACRO(0)",
      "MACRO(1)",
      "MACRO(2)",
      "MACRO(3)",
      "MACRO(4)",
      "MACRO(5)",
      "MACRO(6)",
      "MACRO(7)",
      "MACRO(8)",
      "MACRO(9)",
      "MACRO(10)",
      "MACRO(11)",
      "MACRO(12)",
      "MACRO(13)",
      "MACRO(14)",
      "KC_A",
      "KC_G",
      "KC_D",
      "KC_LEFT",
      "MACRO(0)",
      "KC_MPRV",
      "KC_MNXT",
      "KC_VOLD",
      "KC_VOLU"
    ],
    [
      "RGB_MOD",
      "RGB_HUI",
      "RGB_SAI",
      "RGB_VAI",
      "RGB_SPI",
      "RGB_RMOD",
      "RGB_HUD",
      "RGB_SAD",
      "RGB_VAD",
      "RGB_SPD",
      "KC_TRNS",
      "RGB_TOG",
      "RGB_M_P",
      "RGB_M_B",
      "RGB_M_R",
      "RGB_M_SW",
      "RGB_M_R",
      "RGB_M_P",
      "RGB_SAI",
      "RGB_SAD",
      "RGB_VAI",
      "RGB_VAD",
      "RGB_HUI",
      "RGB_HUD"
    ],
    [
      "KC_TRNS",
      "KC_TRNS",
      "KC_TRNS",
      "KC_TRNS",
      "KC_TRNS",
      "KC_TRNS",
      "KC_TRNS",
      "KC_TRNS",
      "KC_TRNS",
      "KC_TRNS",
      "KC_TRNS",
      "KC_TRNS",
      "KC_TRNS",
      "KC_TRNS",
      "KC_TRNS",
      "KC_TRNS",
      "KC_TRNS",
      "KC_TRNS",
      "KC_TRNS",
      "KC_TRNS",
      "KC_TRNS",
      "KC_TRNS",
      "KC_TRNS",
      "KC_TRNS"
    ],
    [
      "KC_TRNS",
      "KC_TRNS",
      "KC_TRNS",
      "KC_TRNS",
      "KC_TRNS",
      "KC_TRNS",
      "KC_TRNS",
      "KC_TRNS",
      "KC_TRNS",
      "KC_TRNS",
      "KC_TRNS",
      "KC_TRNS",
      "KC_TRNS",
      "KC_TRNS",
      "KC_TRNS",
      "KC_TRNS",
      "KC_TRNS",
      "KC_TRNS",
      "KC_TRNS",
      "KC_TRNS",
      "KC_TRNS",
      "KC_TRNS",
      "KC_TRNS",
      "KC_TRNS"
    ],
    [
      "KC_TRNS",
      "KC_TRNS",
      "KC_TRNS",
      "KC_TRNS",
      "KC_TRNS",
      "KC_TRNS",
      "KC_TRNS",
      "KC_TRNS",
      "KC_TRNS",
      "KC_TRNS",
      "KC_TRNS",
      "KC_TRNS",
      "KC_TRNS",
      "KC_TRNS",
      "KC_TRNS",
      "KC_TRNS",
      "KC_TRNS",
      "KC_TRNS",
      "KC_TRNS",
      "KC_TRNS",
      "KC_TRNS",
      "KC_TRNS",
      "KC_TRNS",
      "KC_TRNS"
    ],
    [
      "KC_TRNS",
      "KC_TRNS",
      "KC_TRNS",
      "KC_TRNS",
      "KC_TRNS",
      "KC_TRNS",
      "KC_TRNS",
      "KC_TRNS",
      "KC_TRNS",
      "KC_TRNS",
      "KC_TRNS",
      "KC_TRNS",
      "KC_TRNS",
      "KC_TRNS",
      "KC_TRNS",
      "KC_TRNS",
      "KC_TRNS",
      "KC_TRNS",
      "KC_TRNS",
      "KC_TRNS",
      "KC_TRNS",
      "KC_TRNS",
      "KC_TRNS",
      "KC_TRNS"
    ],
    [
      "KC_TRNS",
      "KC_TRNS",
      "KC_TRNS",
      "KC_TRNS",
      "KC_TRNS",
      "KC_TRNS",
      "KC_TRNS",
      "KC_TRNS",
      "KC_TRNS",
      "KC_TRNS",
      "KC_TRNS",
      "KC_TRNS",
      "KC_TRNS",
      "KC_TRNS",
      "KC_TRNS",
      "KC_TRNS",
      "KC_TRNS",
      "KC_TRNS",
      "KC_TRNS",
      "KC_TRNS",
      "KC_TRNS",
      "KC_TRNS",
      "KC_TRNS",
      "KC_TRNS"
    ],
    [
      "KC_TRNS",
      "KC_TRNS",
      "KC_TRNS",
      "KC_TRNS",
      "KC_TRNS",
      "KC_TRNS",
      "KC_TRNS",
      "KC_TRNS",
      "KC_TRNS",
      "KC_TRNS",
      "KC_TRNS",
      "KC_TRNS",
      "KC_TRNS",
      "KC_TRNS",
      "KC_TRNS",
      "KC_TRNS",
      "KC_TRNS",
      "KC_TRNS",
      "KC_TRNS",
      "KC_TRNS",
      "KC_TRNS",
      "KC_TRNS",
      "KC_TRNS",
      "KC_TRNS"
    ]
  ],
  "encoders": []
}
